louvain,colors,all,act,act_Arm,act_Cl13,Arm,Cl13
P0,#d62728,902,13,12,1.0,901,890
P1,#aec7e8,334,332,332,,334,2
P2,#e377c2,577,562,503,59.0,518,74
P3,#ff7f0e,960,960,497,463.0,497,463
P4,#ffbb78,310,310,259,51.0,259,51
P5,#aa40fc,817,817,532,285.0,532,285
P6,#8c564b,806,806,504,302.0,504,302
P7,#b5bd61,505,505,106,399.0,106,399
P8,#17becf,443,443,10,433.0,10,433
P9,#1f77b4,1193,1192,1174,18.0,1175,19
P10,#279e68,956,955,953,2.0,954,3
